2222222222222
2000000000002
2000000000002
2000000000002
2000034300002
2000011100002
2000011100002
2000011100002
2000000000002
2000000000002
2000000000002
2000000000002
2222222222222