0000000000000
0000000000000
0000000000000
0000000000000
0000034300000
0000011100000
0000011100000
0000011100000
0000000000000
0000000000000
0000000000000
0000000000000
0000000000000