0000000000000
0000000000000
0000000000000
0000000000000
0000004000000
0000033300000
0000033300000
0000033300000
0000000000000
0000000000000
0000000000000
0000000000000
0000000000000