22222222222
21113011112
21210121122
21221211212
21111111112
21521211222
21221121122
21111111112
21220211222
21223021222
22222222222