22222222222
21111301112
21221011222
21121221122
21111111112
21251221212
21111221122
21111111112
21221021222
21221301222
22222222222