2222222222222202
2000000000000002
2000000000000002
2000000000000002
2000000000000002
2000000000000002
2000000000000002
2000000000000002
2000000000000002
2000000000000002
2000000000000002
2222222222222222