222222222222222
230000000000002
200000000000002
200000000000002
200000000000002
200000000000002
200000000000002
200000000000002
200000000000002
200000000000002
200000000000032
222222222222222