222222222222222
230611111111002
202121212121202
211111111111112
212121212121212
211111111111112
212121212121212
211111111111112
212121212121212
211111111111112
202121212121202
200111111111032
222222222222222