222222222222222222
230211122111111212
202512112112221112
212222211221111212
211112221111225212
212111111121122112
212221221121221122
212111112122211222
211121211122112212
222111222111112112
211112152122112022
211111111122110032
222222222222222222