22222222222222222
20000222011110002
21310112211300112
21010111111111012
20010012211111002
21010105010101012
22222222222222222