22222222222
21112302112
21221011222
21121221122
21111111112
21251221212
21211221222
21111111112
21221021222
21222301222
22222222222